111111111111111111
1CC00000P000000CC1
10011LL0E00LL11001
100100000000001001
1L01000000000010L1
100100000000001001
100100000000001001
1001100LLLL0011001
1C011100CC001110C1
111111111111111111