11111111111111111111111111111
1P000000000000000000000000001
1000000001111LL11110000000001
10000000011CCCCCC110000000001
1000000001CCCCCCCC10000000001
1000000001CCCLLCCC10000000001
100000000111CCCC1110000000001
100000000001CCCC1000000000001
1000000000001CC10000000000001
1000000000001CC10000000000001
100000000000000000000000000E1
11111111111111111111111111111