1111111111111111111111111
10000CCCCLL0P0LLCCCC00001
1001111111100011111111001
100000000000C000000000001
100LLCCCCLL0C0LLCCCCLL001
100111111110C011111111001
100000000000C000000000001
100LLCCCCLL0C0LLCCCCLL001
100111111110C011111111001
1000000000000000000000001
100000000000E000000000001
1111111111111111111111111