1111111111111111111111111111111111111111111111
1000000000000000CCCCCCCCCCCCCC00000000000000E1
1000111111111111111111111111111111111111110001
1000000000000000000000000000000000000000000001
1000000LLL0000000CCCCCCCCCCCC0000000LLL0000001
1000000111111111111111111111111111111110000001
1000000000000000000000000000000000000000000001
1000000000LL000000CCCCCCCCCC000000LL0000000001
1000000000111111111111111111111111110000000001
1000000000000000000000000000000000000000000001
1000000000000L00000CCCCCCCC00000L0000000000001
1000000000000111111111111111111110000000000001
1000000000000000000000000000000000000000000001
1000000000000000L000CCCCCC000L0000000000000001
1000000000000000111111111111110000000000000001
1000000000000000000000000000000000000000000001
1000000000000000000L0CCCC0L0000000000000000001
1000000000000000000111111110000000000000000001
1000000000000000000000000000000000000000000001
1P00000000000000000000CC0000000000000000000001
1111111111111111111111111111111111111111111111