111111111111111111
1CC00000P000000CC1
10011000E000011001
100100000000001001
100100000000001001
100100000000001001
100100000000001001
1001100CCCC0011001
1C011100CC001110C1
111111111111111111