1111111111111111111111111
10000CCCC000P000CCCC00001
1001111111100011111111001
100000000000C000000000001
10000CCCC000C000CCCC00001
100111111110C011111111001
100000000000C000000000001
10000CCCC000C000CCCC00001
100111111110C011111111001
1000000000000000000000001
100000000000E000000000001
1111111111111111111111111