1111111111111111111111111111111111111111111111
1000000000000000CCCCCCCCCCCCCC00000000000000E1
1000111111111111111111111111111111111111110001
1000000000000000000000000000000000000000000001
10000000000000000CCCCCCCCCCCC00000000000000001
1000000111111111111111111111111111111110000001
1000000000000000000000000000000000000000000001
100000000000000000CCCCCCCCCC000000000000000001
1000000000111111111111111111111111110000000001
1000000000000000000000000000000000000000000001
1000000000000000000CCCCCCCC0000000000000000001
1000000000000111111111111111111110000000000001
1000000000000000000000000000000000000000000001
10000000000000000000CCCCCC00000000000000000001
1000000000000000111111111111110000000000000001
1000000000000000000000000000000000000000000001
100000000000000000000CCCC000000000000000000001
1000000000000000000111111110000000000000000001
1000000000000000000000000000000000000000000001
1P00000000000000000000CC0000000000000000000001
1111111111111111111111111111111111111111111111