1111111111111111111111
1E00000000000000000001
1000000000110000000001
1000000111111110000001
1000000111111110000001
1000000000110000000001
1000000000110000000001
1000000000110000000001
1000000000110000000001
1P00000000000000000001
1111111111111111111111